NO ./src/textures/wall1.xpm
SO ./src/textures/wall2.xpm
WE ./src/textures/wall3.xpm
EA ./src/textures/wall4.xpm

F 220,100,0
C 225,30,0

111111111111111111111
100000000000000000001
100000000000000000001
111111111121111111111
100000000000000000001
1000000000N0000000001
111111111111111111111