NO ./src/textures/wall1.xpm
SO ./src/textures/wall2.xpm
WE ./src/textures/wall3.xpm
EA ./src/textures/wall4.xpm

F 75,75,75
C 50,50,50


       1111111111111111111111111
       1000000000110000000000001
       1011000001110000000000001
       1001000000000000000000001
       1111111111111111111111101
        111111111111111111111101
111111111011000001110000000000001111111111111
100000000011000001110111111110000000000000001111111
111101111111110111000000100011111111111111101111111
1111011111111101110101000000001            1001111111
1100000011010101110000001000101            1001
1000000000000000000000001000001            1001
1000000000000000110101001000001            1001
1100000111010101111101111000001            1001
11110111 111010111011110100S011            1001
11111111 1111111 111111111111111111111111111111
                              111111