NO ./path_to_the_north_texture
SO ./path_to_the_south_texture
WE ./path_to_the_west_texture
EA ./path_to_the_east_texture

F 220,100,0
C 225,30,0


       1111111111111111111111111
       1000000000110000000000001
       1011000001110000000000001
       1001000000000000000000001
       1111111111111111111111101
        111111111111111111111101
111111111011000001110000000000001111111111111
100000000011000001110111111110000000000000001111111
111101111111110111000000100011111111111111101111111
1111011111111101110101000000001            1001111111
1100000011010101110000001000101            1001
1000000000000000000000001000001            1001
1000000000000000110101001000001            1001
110000011101010111110111100N001            1001
11110111 1110101110111101000011            1001
11111111 1111111 1111111111111111111111111111
                              111111