NO ./src/textures/wall1.xpm
SO ./src/textures/wall1.xpm
WE ./src/textures/wall1.xpm
EA ./src/textures/wall1.xpm

F 75,75,75
C 50,50,50


       1111111111111111111111111
       1000000000110000000000001
       1011000001110000000000001
       1001000000000000000000001
       1111111111111111111111101
        111111111111111111111101
1111111110110000011100000000000011111111111111111111
1111100100000000000000000000100000000000000000001111
1000000000110000011101111112100000000000000000001111
111101111111110111000000100011111111111111100001111
1111011111111101110101002000002000000000001121111
11000000110101011100000010001111111111111111001
1000000000000000000000001000001            1001
1000000000000000110101001000001            1001
1100000111010101111101111000001            1001
11110111 111010111011110100N011            1001
11111111 1111111 111111111111111111111111111111
                              111111