NO ./src/textures/wall1.xpm
SO ./src/textures/wall1.xpm
WE ./src/textures/wall1.xpm
EA ./src/textures/wall1.xpm

F 75,75,75
C 50,50,50

11111111111111111111111111111111111111111
10000000000000000000000000000000000000001
12121212121212121212121212121212121212121
10000000000000000000000000000000000000001
1E000000000000000000000000000000000000001
11111111111111111111111111111111111111111