NO ./src/textures/wall1.xpm
SO ./src/textures/wall1.xpm
WE ./src/textures/wall1dasd.xpm
EA ./src/textures/wall1.xpm

F 75,75,75
C 50,50,50


1111
10N1
1111